# Rime table
# coding: utf-8
#@/db_name  custom_phrase.txt
#@/db_type	tabledb
#
# 用於【朙月拼音】系列輸入方案
# 【小狼毫】0.9.21 以上
#
# 請將該文件以UTF-8編碼保存爲
# Rime用戶文件夾/custom_phrase.txt
#
# 碼表各字段以製表符（Tab）分隔
# 順序爲：文字、編碼、權重（決定重碼的次序、可選）
#
# 雖然文本碼表編輯較爲方便，但不適合導入大量條目
#
# no comment


Rime	rime	4
鼠须管	rime	3
https://rime.im/	rime	2
Squirrel	rime	1

App Store	as	2
Apple Store	as	1
AppleCare+	ac
Apple ID	aid
Apple Music	am
AirPods	ap	4
Apple Pay	ap	3
Alipay	ap	2

Apple TV	atv
Apple Watch	aw
Android	az

Chrome	ch
Command	cm
Control	ct
CarPlay	cp

Emoji	em

GitHub	gh
Gmail	gm
Google	gg
Google Pay	gp
Google Play	gp	2
Google Voice	gv
Gboard	gb

Hi	hi

iCloud	ic

iMac	imac	
iPad	ipad
iPhone	ip
IPv6	ipv

Mac	mac
	
MacBook Pro	mbp
MacBook Air	mba
㎡	pfm

🐂️🍺️	nb

1Password	one	2
OneDrive	one	1

Parallels Desktop	pd
Photoshop	ps
Paypal	pp

QQ	qq

Safari	sf	2
Shift	sf	1
SSD	ssd

Telegram	tg
Twitter	tt
Type-C	tc
Up主	upzhu

WeChat	wc	2

YouTube	yt
YouTube Premium	yp
又双叒叕	yyy






